08 08 08 08 08 08 08 08 08 08 08 08 08 08 08 08 08 08 08 08 08 08 08 08 08 08 08 08 08 08 08 08 08 08 08 08 08 08 08 08 08 08 08 08 08 08 08 08 08 08 08
08 08 08 08 08 08 08 08 08 08 08 08 08 08 08 08 08 08 08 08 08 08 08 08 08 08 08 08 08 08 08 08 08 08 08 08 08 08 08 08 08 08 08 08 08 08 08 08 08 08 08
08 08 08 08 08 08 08 08 08 08 08 08 08 08 08 08 08 08 08 08 08 08 04 04 04 16 16 16 16 16 16 16 16 16 16 04 04 04 04 04 16 16 16 16 16 16 08 08 08 08 08
08 08 08 08 08 08 08 08 08 08 08 08 08 16 16 16 16 04 04 04 04 04 04 04 04 16 16 16 16 16 16 16 16 16 16 04 04 04 04 04 16 16 16 16 16 16 08 08 08 08 08
08 08 08 08 08 08 08 08 08 08 08 08 16 16 16 16 16 16 04 04 04 04 04 04 04 16 16 16 16 16 16 16 16 16 16 04 04 04 04 04 16 16 16 16 16 16 08 08 08 08 08 
08 08 08 08 08 08 08 08 04 04 04 04 16 16 16 16 16 18 04 04 04 04 04 04 04 16 16 08 08 08 08 08 16 16 16 04 04 04 04 04 16 16 16 08 08 08 08 08 08 08 08
08 08 08 08 08 08 08 08 04 04 04 04 16 16 16 16 16 16 04 04 04 04 04 04 04 16 16 08 08 08 08 08 16 16 16 04 04 04 04 04 16 16 16 08 08 08 08 08 08 08 08
08 08 08 08 08 08 08 08 04 04 04 04 04 04 16 16 16 04 04 04 04 04 04 04 04 16 16 16 08 08 08 08 16 16 16 04 04 04 04 04 16 16 16 08 08 08 08 08 08 08 08
08 08 08 08 08 08 08 08 04 04 04 04 04 04 16 16 16 04 04 04 04 04 04 04 04 16 16 16 08 08 08 08 16 16 16 04 04 04 04 04 16 16 16 08 08 08 08 08 08 08 08
08 08 08 08 08 08 08 08 04 04 04 16 16 16 16 16 16 04 04 04 04 04 04 04 04 16 16 16 08 08 08 08 16 16 16 04 04 04 04 04 16 16 16 08 08 08 08 08 08 08 08
08 08 08 08 08 08 08 08 04 04 04 16 16 16 16 16 16 04 04 04 04 04 04 04 16 16 16 16 16 08 08 08 16 16 16 04 04 04 04 04 16 16 16 08 08 08 08 08 08 08 08
08 08 08 08 08 08 08 08 04 04 04 16 16 16 04 04 04 04 04 04 04 04 04 04 16 16 16 16 16 08 08 08 16 16 16 16 16 16 16 16 16 16 16 08 08 08 08 08 08 08 08
08 08 08 08 08 08 08 08 04 04 04 16 16 16 04 04 04 04 04 04 04 04 04 04 16 16 16 16 16 08 08 08 16 16 16 16 16 16 16 16 16 16 16 08 08 08 08 08 08 08 08
08 08 08 08 08 08 08 08 04 04 04 16 16 04 04 04 04 04 04 04 04 04 04 04 16 16 16 16 16 08 08 08 16 16 16 16 16 16 16 16 16 16 16 08 08 08 08 08 08 08 08
08 08 08 08 08 08 08 08 04 04 04 16 16 04 04 04 04 04 04 04 04 04 04 04 16 16 16 16 16 08 08 08 08 08 08 08 08 08 08 08 08 08 08 08 08 08 08 08 08 08 08
08 08 08 08 08 08 08 08 04 04 04 16 16 16 04 04 04 04 04 04 04 04 04 04 16 16 16 16 16 08 08 08 08 08 08 08 08 08 08 08 08 08 08 08 08 08 08 08 08 08 08
08 08 08 08 08 08 04 04 04 04 04 16 16 16 04 04 04 04 04 04 04 04 04 04 16 16 16 16 16 08 08 08 08 08 08 08 08 08 08 08 08 08 08 08 08 08 08 08 08 08 08
08 08 08 08 04 04 04 04 04 04 04 16 16 16 04 04 04 04 04 04 04 04 04 04 16 16 16 16 16 08 08 08 08 08 08 08 08 08 08 08 08 08 08 08 08 08 08 08 08 08 08
08 08 08 04 04 04 04 04 04 04 04 16 16 16 04 04 04 04 04 04 04 04 04 04 16 16 16 16 16 08 08 08 08 08 08 08 08 08 08 08 08 08 08 08 08 08 08 08 08 08 08
08 08 04 04 04 04 04 16 16 16 16 16 16 16 16 16 16 04 04 04 04 04 04 04 16 16 16 16 16 08 08 08 08 08 08 08 08 08 08 08 08 08 08 08 08 08 08 08 08 08 08
08 08 04 04 04 04 04 16 16 16 16 16 16 16 16 16 16 04 04 04 04 04 04 04 16 16 16 16 16 08 08 08 08 08 08 08 08 08 08 08 08 08 08 08 08 08 08 08 08 08 08
08 04 04 04 04 04 04 16 16 16 16 16 16 16 16 16 16 16 16 16 16 16 16 16 16 16 16 16 16 16 16 16 16 16 16 16 16 16 16 16 16 16 16 16 16 08 08 08 08 08 08
08 04 04 16 16 16 16 16 16 16 16 16 16 16 16 16 16 16 16 16 16 16 16 16 16 16 16 16 16 16 16 16 16 16 16 16 16 16 16 16 16 16 16 16 16 08 08 08 08 08 08
08 16 16 16 16 16 16 16 16 16 16 16 16 16 16 16 16 16 16 16 16 16 16 16 16 16 16 16 16 16 16 16 16 16 16 16 16 16 16 16 16 16 16 16 16 08 08 08 08 08 08
08 16 16 16 16 16 16 16 16 16 16 16 16 16 16 16 16 16 16 16 16 16 16 16 16 16 16 16 16 08 08 08 16 16 04 04 04 04 04 04 04 04 04 16 16 08 08 08 08 08 08
08 16 16 08 08 08 08 16 16 16 16 16 16 16 16 16 16 16 16 16 16 16 16 16 16 16 16 16 16 08 08 08 16 16 04 04 04 04 04 04 04 04 04 16 16 08 08 08 08 08 08
08 16 16 08 08 08 08 04 04 04 04 04 04 04 04 04 04 04 04 04 04 04 04 04 04 04 04 04 04 04 04 04 16 16 04 04 04 04 04 04 04 04 04 16 16 08 08 08 08 08 08
08 16 16 08 08 08 08 04 04 04 04 04 04 04 04 04 04 04 04 04 04 04 04 04 04 04 04 04 04 04 04 04 16 16 04 04 04 04 04 04 04 04 04 16 16 08 08 08 08 08 08
08 16 16 08 08 08 08 08 08 08 08 08 08 08 08 08 08 08 08 08 08 08 08 08 08 08 08 08 08 08 08 08 16 16 04 04 04 04 04 04 04 04 04 16 16 08 08 08 08 08 08
08 16 16 08 08 08 08 08 08 08 08 08 08 08 08 08 08 08 08 08 08 08 08 08 08 08 08 08 08 08 08 08 16 16 04 04 04 04 04 04 04 04 04 16 16 08 08 08 08 08 08
08 16 16 08 08 08 08 08 08 08 08 08 08 08 08 08 08 08 08 08 08 08 08 08 08 08 08 08 08 08 08 08 16 16 04 04 04 04 04 04 04 04 04 16 16 08 08 08 08 08 08
08 16 16 08 08 08 08 08 08 08 08 08 08 08 08 08 08 08 08 08 08 08 08 08 08 08 08 08 08 08 08 08 16 16 04 04 04 04 04 04 04 04 04 16 16 08 08 08 08 08 08
08 16 16 08 08 08 08 08 08 08 08 08 08 08 08 08 08 08 08 08 08 08 08 08 08 08 08 08 08 08 08 08 16 16 04 04 04 04 04 04 04 04 04 16 16 08 08 08 08 08 08
08 16 16 16 16 16 16 16 16 16 16 16 16 16 16 16 16 08 08 08 08 08 08 08 08 08 08 08 08 08 08 08 16 16 04 04 04 04 04 04 04 04 04 16 16 08 08 08 08 08 08
08 16 16 16 16 16 16 16 16 16 16 16 16 16 16 16 16 08 08 08 08 08 08 08 08 08 08 08 08 08 08 08 16 16 16 16 16 16 16 16 16 16 16 16 16 08 08 08 08 08 08
08 16 16 16 16 16 16 16 16 16 16 16 16 16 16 16 16 08 08 08 08 08 08 08 08 08 08 08 08 08 08 08 16 16 16 16 16 16 16 16 16 16 16 16 16 08 08 08 08 08 08
08 08 08 08 08 08 08 08 08 08 08 08 08 08 08 08 08 08 08 08 08 08 08 08 08 08 08 08 08 08 08 08 16 16 16 16 16 16 16 16 16 16 16 16 16 08 08 08 08 08 08
08 08 08 08 08 08 08 08 08 08 08 08 08 08 08 08 08 08 08 08 08 08 08 08 08 08 08 08 08 08 08 08 08 08 08 08 08 08 08 08 08 08 08 08 08 08 08 08 08 08 08
08 08 08 08 08 08 08 08 08 08 08 08 08 08 08 08 08 08 08 08 08 08 08 08 08 08 08 08 08 08 08 08 08 08 08 08 08 08 08 08 08 08 08 08 08 08 08 08 08 08 08
