08 08 08 08 08 08 08 08 08 08 08 08 08 08 08 08 08 08 08 08 08 08 08 08 08 08 08 08 08 08 08 08 08 08 08 08 08 08 08 08 08 08 08 08 08 08 08 08 08 08 08
08 08 08 08 08 08 08 08 08 08 08 08 08 08 08 08 08 08 08 08 08 08 08 08 08 08 08 08 08 08 08 08 08 08 08 08 08 08 08 08 08 08 08 08 08 08 08 08 08 08 08
08 08 08 08 08 08 08 08 08 08 08 08 08 08 08 08 08 08 08 08 08 08 04 04 04 16 16 16 16 16 16 16 16 16 04 04 04 04 04 04 04 16 16 16 16 16 08 08 08 08 08
08 08 08 08 08 08 08 08 08 08 08 08 08 16 16 16 16 04 04 04 04 04 04 04 04 16 16 16 16 16 16 16 16 16 04 04 04 04 04 04 04 16 16 16 16 16 08 08 08 08 08
08 08 08 08 08 08 08 08 08 08 08 08 08 16 16 16 16 16 04 04 04 04 04 04 04 16 16 08 08 08 08 08 16 16 04 04 04 04 04 04 04 16 16 16 16 16 08 08 08 08 08 
08 08 08 08 08 08 08 08 04 04 04 04 04 16 16 16 16 18 04 04 04 04 04 04 04 16 16 08 08 08 08 08 16 16 04 04 04 04 04 04 04 16 16 08 08 08 08 08 08 08 08
08 08 08 08 08 08 08 08 04 04 04 04 04 16 16 16 16 16 04 04 04 04 04 04 04 16 16 08 08 08 08 08 16 16 04 04 04 04 04 04 04 16 16 08 08 08 08 08 08 08 08
08 08 08 08 08 08 08 08 04 04 04 04 04 04 16 16 16 04 04 04 04 04 04 04 04 16 16 08 08 08 08 08 16 16 04 04 04 04 04 04 04 16 16 08 08 08 08 08 08 08 08
08 08 08 08 08 08 08 08 04 04 04 04 04 04 16 16 16 04 04 04 04 04 04 04 04 16 16 08 08 08 08 08 16 16 04 04 04 04 04 04 04 16 16 08 08 08 08 08 08 08 08
08 08 08 08 08 08 08 08 04 04 04 16 16 16 16 16 16 04 04 04 04 04 04 04 04 16 16 08 08 08 08 08 16 16 04 04 04 04 04 04 04 16 16 08 08 08 08 08 08 08 08
08 08 08 08 08 08 08 08 04 04 04 16 16 16 16 16 16 04 04 04 04 04 04 04 04 16 16 08 08 08 08 08 16 16 04 04 04 04 04 04 04 16 16 08 08 08 08 08 08 08 08
08 08 08 08 08 08 08 08 04 04 04 16 16 04 04 04 04 04 04 04 04 04 04 04 04 16 16 08 08 08 08 08 16 16 04 04 04 04 04 04 04 16 16 08 08 08 08 08 08 08 08
08 08 08 08 08 08 08 08 04 04 04 16 16 04 04 04 04 04 04 04 04 04 04 04 04 16 16 08 08 08 08 08 16 16 16 16 16 16 16 16 16 16 16 08 08 08 08 08 08 08 08
08 08 08 08 08 08 08 08 04 04 04 16 16 04 04 04 04 04 04 04 04 04 04 04 04 16 16 08 08 08 08 08 16 16 16 16 16 16 16 16 16 16 16 08 08 08 08 08 08 08 08
08 08 08 08 08 08 08 08 04 04 04 16 16 04 04 04 04 04 04 04 04 04 04 04 04 16 16 08 08 08 08 08 08 08 08 08 08 08 08 08 08 08 08 08 08 08 08 08 08 08 08
08 08 08 08 08 08 08 08 04 04 04 16 16 04 04 04 04 04 04 04 04 04 04 04 04 16 16 08 08 08 08 08 08 08 08 08 08 08 08 08 08 08 08 08 08 08 08 08 08 08 08
08 08 08 08 08 08 04 04 04 04 04 16 16 04 04 04 04 04 04 04 04 04 04 04 04 16 16 08 08 08 08 08 08 08 08 08 08 08 08 08 08 08 08 08 08 08 08 08 08 08 08
08 08 08 08 04 04 04 04 04 04 04 16 16 04 04 04 04 04 04 04 04 04 04 04 04 16 16 08 08 08 08 08 08 08 08 08 08 08 08 08 08 08 08 08 08 08 08 08 08 08 08
08 08 08 04 04 04 04 04 04 04 04 16 16 04 04 04 04 04 04 04 04 04 04 04 04 16 16 08 08 08 08 08 08 08 08 08 08 08 08 08 08 08 08 08 08 08 08 08 08 08 08
08 08 04 04 04 04 04 04 04 04 04 16 16 04 04 04 04 04 04 04 04 04 04 04 04 16 16 08 08 08 08 08 08 08 08 08 08 08 08 08 08 08 08 08 08 08 08 08 08 08 08
08 08 04 04 04 04 04 04 04 04 04 16 16 04 04 04 04 04 04 04 04 04 04 04 04 16 16 08 08 08 08 08 08 08 08 08 08 08 08 08 08 08 08 08 08 08 08 08 08 08 08
08 04 04 04 04 04 04 04 04 04 04 16 16 04 04 04 04 04 04 04 04 04 04 04 04 16 16 16 16 16 16 16 16 16 16 16 16 16 16 16 16 16 16 16 16 08 08 08 08 08 08
08 04 04 04 04 04 04 04 04 04 04 16 16 17 17 17 17 17 17 17 17 17 17 17 17 16 16 16 16 16 16 16 16 16 16 16 16 16 16 16 16 16 16 16 16 08 08 08 08 08 08
08 16 16 16 16 16 16 16 16 16 16 16 16 17 17 17 17 17 17 17 17 17 17 17 17 16 16 08 08 08 08 08 16 16 04 04 04 04 04 04 04 04 04 16 16 08 08 08 08 08 08
08 16 16 16 16 16 16 16 16 16 16 16 16 17 17 17 17 17 17 17 17 17 17 17 17 16 16 08 08 08 08 08 16 16 04 04 04 04 04 04 04 04 04 16 16 08 08 08 08 08 08
08 16 16 04 04 04 04 08 08 08 08 08 08 04 04 04 04 04 04 04 04 04 04 04 04 08 08 08 08 08 08 08 16 16 04 04 04 04 04 04 04 04 04 16 16 08 08 08 08 08 08
08 16 16 04 04 04 04 08 08 08 08 08 08 04 04 04 04 04 04 04 04 04 04 04 04 08 08 08 08 08 08 08 16 16 04 04 04 04 04 04 04 04 04 16 16 08 08 08 08 08 08
08 16 16 04 04 04 04 08 08 08 08 08 08 04 04 04 04 04 04 04 04 04 04 04 04 08 08 08 08 08 08 08 16 16 04 04 04 04 04 04 04 04 04 16 16 08 08 08 08 08 08
08 16 16 04 04 04 04 08 08 08 08 08 08 08 08 08 08 08 08 08 08 08 08 08 08 08 08 08 08 08 08 08 16 16 04 04 04 04 04 04 04 04 04 16 16 08 08 08 08 08 08
08 16 16 04 04 04 04 08 08 08 08 08 08 08 08 08 08 08 08 08 08 08 08 08 08 08 08 08 08 08 08 08 16 16 04 04 04 04 04 04 04 04 04 16 16 08 08 08 08 08 08
08 16 16 04 04 04 04 08 08 08 08 08 08 08 08 08 08 08 08 08 08 08 08 08 08 08 08 08 08 08 08 08 16 16 04 04 04 04 04 04 04 04 04 16 16 08 08 08 08 08 08
08 16 16 04 04 04 04 08 08 08 08 08 08 08 08 08 08 08 08 08 08 08 08 08 08 08 08 08 08 08 08 08 16 16 04 04 04 04 04 04 04 04 04 16 16 08 08 08 08 08 08
08 16 16 04 04 04 04 08 08 08 08 08 08 08 08 08 08 08 08 08 08 16 16 16 16 16 08 08 08 08 08 08 16 16 04 04 04 04 04 04 04 04 04 16 16 08 08 08 08 08 08
08 16 16 04 04 04 04 08 08 08 08 08 08 08 08 08 08 08 08 08 08 16 16 16 16 16 08 08 08 08 08 08 16 16 04 04 04 04 04 04 04 04 04 16 16 08 08 08 08 08 08
08 16 16 16 16 16 16 16 16 16 16 16 16 16 16 16 16 16 16 16 16 16 16 16 16 16 08 08 08 08 08 08 16 16 04 04 04 04 04 04 04 04 04 16 16 08 08 08 08 08 08
08 16 16 16 16 16 16 16 16 16 16 16 16 16 16 16 16 16 16 16 16 16 16 16 16 16 08 08 08 08 08 08 16 16 16 16 16 16 16 16 16 16 16 16 16 08 08 08 08 08 08
08 08 08 08 08 08 08 08 08 08 08 08 08 08 08 08 08 08 08 08 08 16 16 16 16 16 08 08 08 08 08 08 16 16 16 16 16 16 16 16 16 16 16 16 16 08 08 08 08 08 08
08 08 08 08 08 08 08 08 08 08 08 08 08 08 08 08 08 08 08 08 08 08 08 08 08 08 08 08 08 08 08 08 08 08 08 08 08 08 08 08 08 08 08 08 08 08 08 08 08 08 08
08 08 08 08 08 08 08 08 08 08 08 08 08 08 08 08 08 08 08 08 08 08 08 08 08 08 08 08 08 08 08 08 08 08 08 08 08 08 08 08 08 08 08 08 08 08 08 08 08 08 08
