13 13 13 13 13 13 13 13 13 13 13 13 13 13 13 13 13 13 13 13 13 13 13 13 13 13 13 13 13 13 13 13 13 13 13 13 13 13 13 13 13 13 13 13 13 13 13 13 13 13 13
13 13 13 13 13 13 13 13 13 13 13 13 13 13 13 13 13 13 13 13 13 13 13 13 13 13 13 13 13 13 13 13 13 13 13 13 13 13 13 13 13 13 13 13 13 13 13 13 13 13 13
13 13 13 13 13 13 13 13 13 13 13 13 13 13 13 13 13 13 13 13 13 13 13 13 13 13 13 13 13 13 13 13 13 13 13 13 13 13 13 14 14 14 14 14 14 14 14 13 13 13 13
13 13 13 13 13 13 13 13 13 13 13 13 13 13 13 13 13 13 13 13 13 13 13 13 13 13 13 13 13 13 13 13 13 13 13 13 13 13 14 14 14 14 14 14 14 14 14 13 13 13 13
13 12 12 12 13 13 13 12 12 12 12 12 12 14 14 14 14 14 14 12 12 12 12 12 12 12 12 12 12 12 12 12 12 12 12 12 12 12 14 14 14 14 14 14 14 14 14 13 13 13 13
13 12 12 12 13 13 13 12 12 12 12 12 12 14 15 14 14 14 14 12 12 12 12 12 12 12 12 12 12 12 12 12 12 12 12 12 14 14 14 14 14 14 14 13 13 13 13 13 13 13 13
13 12 12 12 13 13 13 12 12 12 12 12 12 14 14 14 14 14 14 14 12 12 12 12 12 12 12 12 12 12 12 12 12 12 12 12 14 14 14 14 13 13 13 13 13 13 13 13 13 13 13
13 12 12 12 13 13 13 12 12 12 12 12 12 12 12 12 12 14 14 14 12 12 12 12 12 12 12 12 12 12 12 12 12 12 12 12 14 14 14 14 13 13 13 13 13 13 13 13 13 13 13
13 12 12 12 12 13 13 12 12 12 12 12 12 12 12 12 12 14 14 14 12 12 12 12 12 12 12 12 12 12 12 12 12 12 12 12 14 14 14 14 13 13 13 13 13 13 13 13 13 13 13
13 13 13 13 12 12 12 12 12 12 12 12 12 12 12 12 12 14 14 14 12 12 12 12 12 12 12 12 12 12 12 12 12 12 12 12 12 14 14 14 13 13 13 13 13 13 13 13 13 13 13
13 13 13 13 12 12 12 12 12 12 12 12 12 12 12 12 12 14 14 14 12 12 12 12 12 12 12 12 12 12 12 12 12 12 12 12 12 14 14 14 13 13 13 13 13 13 13 13 13 13 13
13 13 13 13 13 13 13 12 12 12 12 12 12 12 12 12 12 14 14 14 12 12 12 12 12 12 12 12 12 12 12 12 12 12 12 12 12 14 14 14 13 13 13 13 13 13 13 13 13 13 13
13 13 12 12 12 12 12 12 12 12 12 12 12 12 12 12 12 14 14 14 12 12 12 12 12 12 12 12 12 12 12 12 12 12 12 12 12 12 14 14 13 13 13 13 13 13 13 13 13 13 13
13 13 14 14 14 12 12 12 12 12 12 12 12 12 12 12 12 14 14 14 12 12 12 12 12 12 12 12 12 12 12 12 12 12 12 12 12 14 14 14 13 13 13 13 13 13 13 13 13 13 13
13 13 14 14 14 12 12 12 12 12 12 12 12 12 12 12 12 14 14 14 14 14 14 14 14 14 12 14 14 14 14 14 14 14 14 14 14 14 14 14 13 13 13 13 13 13 13 13 13 13 13
13 13 13 14 14 14 14 14 14 14 12 12 12 12 12 12 12 14 14 14 14 14 14 14 14 14 14 14 14 14 14 14 14 14 14 14 14 14 14 14 13 13 13 13 13 13 13 13 13 13 13
13 13 13 14 14 14 14 14 14 14 12 12 12 12 12 12 12 14 14 14 14 14 14 14 14 14 14 14 14 14 14 14 14 14 14 14 14 14 14 14 13 13 13 13 13 13 13 13 13 13 13
13 13 13 14 14 14 14 14 14 14 12 12 12 12 12 12 12 14 14 14 12 12 12 12 12 12 12 12 14 14 12 12 12 12 12 12 12 14 14 14 13 13 13 13 13 13 13 13 13 13 13
13 13 13 13 12 12 14 14 14 14 12 12 12 12 12 12 12 14 14 14 12 12 12 12 12 12 12 12 14 14 13 13 13 13 13 13 13 14 14 14 13 13 13 13 13 13 13 13 13 13 13
13 13 13 13 13 13 12 14 14 12 12 12 12 12 12 12 12 14 14 14 12 12 12 12 12 12 12 12 14 14 13 13 13 13 13 13 13 14 14 14 13 13 13 13 13 13 13 13 13 13 13
13 13 13 13 13 13 12 14 14 12 12 12 12 12 12 12 12 14 14 14 12 12 12 12 12 12 12 12 14 14 13 13 13 13 13 13 13 14 14 14 13 13 13 13 13 13 13 13 13 13 13
13 13 13 13 13 13 12 14 14 12 12 13 13 13 12 12 12 14 14 14 12 12 12 12 12 12 12 12 14 14 13 13 13 13 13 13 13 14 14 14 13 13 13 13 13 13 13 13 13 13 13
13 13 13 13 13 13 12 14 14 13 13 14 14 14 12 12 12 14 14 14 14 14 14 14 14 14 14 14 14 14 13 13 13 13 13 13 12 14 14 14 13 13 13 13 13 13 13 13 13 13 13
13 13 13 13 13 13 14 14 14 13 13 14 14 14 12 12 12 14 14 14 14 14 14 14 14 14 14 14 14 14 13 13 13 13 13 12 14 14 14 14 13 13 13 13 13 13 13 13 13 13 13
13 13 13 13 13 13 14 14 14 14 14 14 14 14 12 12 12 12 12 12 12 12 12 12 12 12 12 12 12 12 13 13 13 13 13 14 14 14 14 14 13 13 13 13 13 13 13 13 13 13 13
13 13 13 13 13 13 14 14 14 14 14 14 18 14 13 13 13 13 13 13 13 13 13 13 13 13 13 13 13 13 13 13 13 13 12 14 14 14 14 12 13 13 13 13 13 13 13 13 13 13 13
13 13 13 13 13 13 14 14 14 14 14 14 14 14 13 13 13 13 13 13 13 13 13 13 13 13 13 13 13 13 13 13 13 13 14 14 14 14 14 12 13 13 13 13 13 13 13 13 13 13 13
13 13 13 13 13 13 14 14 14 14 14 13 13 13 13 13 13 13 13 13 13 13 13 13 13 13 13 13 13 13 13 13 12 12 14 14 14 14 14 12 13 13 13 13 13 13 13 13 13 13 13
13 13 13 13 13 13 13 14 14 14 14 14 13 13 13 13 13 13 13 13 13 13 13 13 13 13 13 13 13 12 12 12 12 14 14 14 14 14 12 12 13 13 13 13 13 13 13 13 13 13 13
13 13 13 13 13 13 13 13 14 14 14 14 12 12 12 12 12 12 12 12 12 12 12 12 12 12 12 12 12 12 12 12 12 14 14 14 14 14 12 12 13 13 13 13 13 13 13 13 13 13 13
13 13 13 13 13 13 13 12 14 14 14 14 12 12 12 12 12 12 12 12 12 12 12 12 12 12 12 12 12 12 12 12 14 14 14 14 14 12 12 12 13 13 13 13 13 13 13 13 13 13 13
13 13 13 13 13 13 13 12 12 14 14 14 14 14 14 14 14 14 14 14 14 12 14 14 14 14 14 14 14 14 14 14 14 14 14 14 14 12 12 12 13 13 13 13 13 13 13 13 13 13 13
13 13 13 13 13 13 13 12 12 14 14 14 14 14 14 14 14 14 14 14 14 14 14 14 14 14 14 14 14 14 14 14 14 14 14 14 14 12 12 13 13 13 13 13 13 13 13 13 13 13 13
13 13 13 13 13 13 13 12 12 12 14 14 14 14 14 14 14 14 14 14 14 14 14 14 14 14 14 14 14 14 14 14 14 14 14 14 12 12 13 13 13 13 13 13 13 13 13 13 13 13 13
13 13 13 13 13 13 13 12 12 12 12 12 12 12 12 12 12 13 13 13 13 13 13 13 13 13 13 13 13 13 13 13 13 13 13 13 13 13 13 13 13 13 13 13 13 13 13 13 13 13 13
13 13 13 13 13 13 13 13 13 13 13 13 13 13 13 13 13 13 13 13 13 13 13 13 13 13 13 13 13 13 13 13 13 13 13 13 13 13 13 13 13 13 13 13 13 13 13 13 13 13 13
13 13 13 13 13 13 13 13 13 13 13 13 13 13 13 13 13 13 13 13 13 13 13 13 13 13 13 13 13 13 13 13 13 13 13 13 13 13 13 13 13 13 13 13 13 13 13 13 13 13 13
13 13 13 13 13 13 13 13 13 13 13 13 13 13 13 13 13 13 13 13 13 13 13 13 13 13 13 13 13 13 13 13 13 13 13 13 13 13 13 13 13 13 13 13 13 13 13 13 13 13 13
13 13 13 13 13 13 13 13 13 13 13 13 13 13 13 13 13 13 13 13 13 13 13 13 13 13 13 13 13 13 13 13 13 13 13 13 13 13 13 13 13 13 13 13 13 13 13 13 13 13 13
